0,0,0,0,0,0,0,0,0,0
0,0,0,0,0,0,0,0,0,0
0,0,0,0,0,0,0,0,0,0
0,0,0,0,0,0,0,580,581,582
0,0,0,0,0,0,0,609,610,611
580,581,582,0,0,0,0,0,0,0
609,610,611,0,0,0,0,0,0,0
0,0,0,0,0,0,0,257,0,0
0,0,0,0,0,0,0,0,0,0
0,0,0,0,0,0,0,0,0,0
0,0,0,0,0,0,0,0,0,0
0,0,0,0,0,0,330,331,332,0
383,383,383,383,383,383,383,383,383,383
